4 4 5 5 4 4
3 2 9 9 2 3
2 3 2 2 3 2
9 1 2 2 1 9
2 1 2 1 2 1
3 0 2 2 0 9
1 0 0 0 0 1
0 0 0 0 0 0