3 3 3 3 3 3
3 3 2 2 3 3
2 2 2 2 2 2
1 1 1 1 1 1
0 1 0 1 0 1
0 0 0 0 0 0
9 9 0 9 9 0
0 0 0 0 0 0