4 3 3 2 3 5
3 3 4 1 3 3
2 1 2 3 2 2
1 3 1 2 1 3
0 1 0 1 0 1
5 4 0 0 3 0
0 3 2 1 0 3
0 2 0 0 2 1